..........
.WORLD.1..
.level.7..
..........
..........
..*******.
..*...@.*.
..*.#.*.*.
*****...*.
*.#.....*.
*..*#**.**
*??#..*..*
*??......*
**********
