..........
.WORLD.1..
.level.4..
..........
*********.
*?????..*.
***.#.*.**
..*.#**..*
..*#.#.#.*
..*...*..*
..**..*.@*
...*******
..........
