................
.....WORLD.1....
.....level.2....
................
....********....
....*?...#.*....
....*?#..*.*....
....*?*.*..*....
....***.*.**....
.....*.#..*.....
.....*@..**.....
.....*****......
................
