..................
.....WORLD.1......
.....level.3......
..................
.....********.....
....**??*...*.....
....*.??*.#.**....
....*..@#..#.*....
....**#***...*....
.....*.....***....
.....*******......
..................
