....................
......WORLD.1.......
......level.1.......
....................
....*****...........
....*...*...........
..***#..*...........
..*....#**..........
***..#.#.*..........
*...*.**.*...*******
*...*.**.*****...??*
*.#..#...........??*
*****.***.*@**...??*
....*.....**********
....*******.........
