...................
.....WORLD.1.......
.....level.6.......
...................
....***********....
....*.....*.@.*....
....*.#..#..#.*....
....**.*???*.**....
.....*.*???*.*.....
.....*#.***.#*.....
.....*...#...*.....
.....*..**...*.....
.....*********.....
...................
