..........
.WORLD.1..
.level.5..
..........
....*****.
*****...*.
*??.#.#.**
*??#.#..@*
**?.#**.**
.***....*.
...******.
..........
