.................
.....WORLD.2.....
.....level.1.....
.................
....*****........
....*...*****....
....*.#.*...*....
....*...*#*.*....
....***#....*....
.....*.....**....
.....*.@???*.....
.....*******.....
.................
