.................
.....WORLD.2.....
.....level.2.....
.................
.....*****.......
.....*...**......
.....*@#..**.....
.....**.#..*.....
......**.#.*.....
.......**..*.....
........**.*.....
.........*?*.....
.........*?*.....
.........*?*.....
.........***.....
.................
